No. Data Points,Actual,cep,ecl-c,ecl-nc,lpv,rrlyr,All
-100 < 0,ecl-c,0,0,0,65,0,65
-100 < 0,ecl-nc,0,0,0,32,0,32
-100 < 0,lpv,0,0,0,34,0,34
-100 < 0,rrlyr,0,0,0,26,0,26
0 < 100,cep,641,24,27,23,52,767
0 < 100,ecl-c,37,5701,3188,1024,418,10368
0 < 100,ecl-nc,43,2038,8531,1038,373,12023
0 < 100,lpv,24,643,791,10778,84,12320
0 < 100,rrlyr,39,1130,562,245,6014,7990
100 < 200,cep,237,29,14,98,22,400
100 < 200,ecl-c,158,7699,1910,2426,423,12616
100 < 200,ecl-nc,48,1519,9151,3039,174,13931
100 < 200,lpv,8,453,593,6332,37,7423
100 < 200,rrlyr,47,1004,517,638,1087,3293
1000 < 1100,cep,43,0,0,0,8,51
1000 < 1100,ecl-c,0,0,0,0,3,3
1000 < 1100,ecl-nc,0,0,0,1,1,2
1000 < 1100,lpv,0,0,0,297,2,299
1000 < 1100,rrlyr,4,0,0,2,649,655
1100 < 1200,cep,16,0,0,1,6,23
1100 < 1200,ecl-nc,1,0,0,0,0,1
1100 < 1200,lpv,0,0,0,214,3,217
1100 < 1200,rrlyr,3,1,0,0,433,437
1200 < 1300,cep,12,0,0,1,3,16
1200 < 1300,lpv,0,0,0,310,5,315
1200 < 1300,rrlyr,0,2,0,3,374,379
1300 < 1400,cep,3,0,0,1,4,8
1300 < 1400,ecl-c,0,3,0,0,1,4
1300 < 1400,ecl-nc,0,0,0,0,3,3
1300 < 1400,lpv,0,0,0,650,4,654
1300 < 1400,rrlyr,1,2,0,2,574,579
1400 < 1500,cep,0,0,0,0,2,2
1400 < 1500,ecl-c,0,0,0,0,12,12
1400 < 1500,ecl-nc,0,0,0,0,1,1
1400 < 1500,lpv,0,0,0,441,2,443
1400 < 1500,rrlyr,0,2,0,0,301,303
1500 < 1600,cep,1,0,0,0,0,1
1500 < 1600,lpv,0,0,0,27,0,27
1500 < 1600,rrlyr,0,0,0,1,50,51
1600 < 1700,cep,0,0,0,0,1,1
1600 < 1700,lpv,0,0,0,167,0,167
1600 < 1700,rrlyr,1,0,0,0,158,159
1700 < 1800,cep,0,0,0,0,1,1
1700 < 1800,lpv,0,0,0,124,1,125
1700 < 1800,rrlyr,0,0,0,2,78,80
1800 < 1900,lpv,0,0,0,78,0,78
1800 < 1900,rrlyr,0,0,0,0,55,55
1900 < 2000,lpv,0,0,0,11,0,11
1900 < 2000,rrlyr,0,0,0,2,11,13
200 < 300,cep,66,7,0,63,14,150
200 < 300,ecl-c,180,1456,107,1949,291,3983
200 < 300,ecl-nc,34,168,1173,2094,65,3534
200 < 300,lpv,9,35,88,2073,10,2215
200 < 300,rrlyr,56,161,10,638,421,1286
2000 < 2100,lpv,0,0,0,3,0,3
2000 < 2100,rrlyr,0,0,0,0,19,19
2100 < 2200,lpv,0,0,0,6,0,6
2100 < 2200,rrlyr,0,0,0,2,9,11
2200 < 2300,lpv,0,0,0,12,1,13
2200 < 2300,rrlyr,0,0,0,0,9,9
2300 < 2400,ecl-c,0,0,0,0,1,1
2300 < 2400,ecl-nc,0,0,0,0,1,1
2300 < 2400,lpv,0,0,0,84,0,84
2300 < 2400,rrlyr,0,0,0,2,61,63
2400 < 2500,lpv,0,0,0,10,0,10
2400 < 2500,rrlyr,0,0,0,2,6,8
2500 < 2600,cep,0,0,0,0,1,1
2500 < 2600,lpv,0,0,0,69,0,69
2500 < 2600,rrlyr,0,0,0,4,48,52
2600 < 2700,lpv,0,0,0,13,0,13
2600 < 2700,rrlyr,0,0,0,0,17,17
2700 < 2800,lpv,0,0,0,153,1,154
2700 < 2800,rrlyr,0,0,0,6,118,124
2800 < 2900,lpv,0,0,0,52,0,52
2800 < 2900,rrlyr,0,0,0,4,55,59
2900 < 3000,lpv,0,0,0,110,0,110
2900 < 3000,rrlyr,0,0,0,10,86,96
300 < 400,cep,1571,2,0,50,6,1629
300 < 400,ecl-c,262,1208,258,909,112,2749
300 < 400,ecl-nc,67,101,640,1010,28,1846
300 < 400,lpv,11,13,10,1770,6,1810
300 < 400,rrlyr,101,235,34,291,1288,1949
3000 < 3100,lpv,0,0,0,3,0,3
3000 < 3100,rrlyr,0,0,0,0,8,8
3100 < 3200,rrlyr,1,0,0,0,5,6
3200 < 3300,rrlyr,0,0,0,0,1,1
3300 < 3400,rrlyr,0,0,0,0,2,2
3400 < 3500,rrlyr,0,0,0,0,1,1
3500 < 3600,rrlyr,0,0,0,0,5,5
3600 < 3700,rrlyr,0,0,0,1,1,2
3700 < 3800,rrlyr,0,0,0,1,0,1
3900 < 4000,rrlyr,0,0,0,0,2,2
400 < 500,cep,309,0,0,233,130,672
400 < 500,ecl-c,141,207,1,298,69,716
400 < 500,ecl-nc,39,0,0,317,20,376
400 < 500,lpv,11,1,0,457,15,484
400 < 500,rrlyr,26,31,0,100,1796,1953
4000 < 4100,rrlyr,0,0,0,0,1,1
4100 < 4200,rrlyr,0,0,0,0,2,2
4600 < 4700,rrlyr,0,0,0,0,1,1
4800 < 4900,rrlyr,0,0,0,0,1,1
4900 < 5000,rrlyr,0,0,0,0,1,1
500 < 600,cep,280,0,0,12,6,298
500 < 600,ecl-c,67,7,1,69,40,184
500 < 600,ecl-nc,23,1,0,96,6,126
500 < 600,lpv,8,1,0,349,16,374
500 < 600,rrlyr,23,7,1,24,1767,1822
600 < 700,cep,588,0,0,4,8,600
600 < 700,ecl-c,35,287,0,20,55,397
600 < 700,ecl-nc,17,1,3,35,5,61
600 < 700,lpv,5,2,1,495,11,514
600 < 700,rrlyr,26,44,0,16,1309,1395
700 < 800,cep,299,0,0,10,20,329
700 < 800,ecl-c,31,159,0,17,65,272
700 < 800,ecl-nc,8,1,1,14,8,32
700 < 800,lpv,3,0,0,651,10,664
700 < 800,rrlyr,15,43,0,6,1389,1453
800 < 900,cep,421,1,3,30,27,482
800 < 900,ecl-c,27,392,0,11,87,517
800 < 900,ecl-nc,7,0,0,12,6,25
800 < 900,lpv,1,1,0,489,5,496
800 < 900,rrlyr,3,64,0,3,1034,1104
900 < 1000,cep,125,0,0,0,8,133
900 < 1000,ecl-c,0,99,0,2,11,112
900 < 1000,ecl-nc,0,2,0,0,3,5
900 < 1000,lpv,0,0,0,339,1,340
900 < 1000,rrlyr,4,10,1,0,829,844
All,,6267,24997,27616,43636,22891,125407
